0000000000000000000000000
0222222222222222222222220
0222222222222222222222220
0022222222222222222222200
1022222222222222222222201
1002222222222222222222001
1100222222222222222220011
1110222222222222222220111
1110222222222222222220111
1110222222222222222220111
1110222222222222222220111
1110222222222222222220111
1110222222222222222220111
1110222222222222222220111
1110222222222222222220111
1110222222222222222220111
1110222222222222222220111
1110222222222222222220111
1110222222222222222220111
1110222222222222222220111
1110222222222222222220111
1110222222222222222220111
1110022222222222222200111
1111000022222222200001111
1111111022222222201111111
1111110022222222200111111
1111100222222222220011111
1100002222222222222000011
1102222222222222222222011
1102222222222222222222011
1102222222222222222222011
1102222222222222222222011
1102222222222222222222011
1100222222222222222220011
1110222222222222222220111
1110222222222222222220111
1110222222222222222220111
1110222222222222222220111
1110222222222222222220111
1110222222222222222220111
1110222222222222222220111
1110222222222222222220111
1100222222222222222220011
1102222222222222222222011
1002222222222222222222001
0022222222222222222222200
0222222222222222222222220
0222222222222222222222220
0000000000000000000000000
